alain = Alain Greiner <alliance-users@asim.lip6.fr>
bodin = Bruno Bodin <alliance-users@asim.lip6.fr>
boris = Boris Boutillier <alliance-users@asim.lip6.fr>
caba = Jean-Manuel Caba <alliance-users@asim.lip6.fr>
chams = The Chams Project <alliance-users@asim.lip6.fr>
cobell = Sophie Belloeil <alliance-users@asim.lip6.fr>
coriolis = The Coriolis Project <alliance-users@asim.lip6.fr>
czo = Olivier Sirol <alliance-users@asim.lip6.fr>
d2 = Damien Dupuis <alliance-users@asim.lip6.fr>
dom = Dominique Ledu <alliance-users@asim.lip6.fr>
franck = Franck Wajsburt <alliance-users@asim.lip6.fr>
francois = Francois Donnet <alliance-users@asim.lip6.fr>
fred = Frederic Petrot <alliance-users@asim.lip6.fr>
gregoire = Gregoire Avot <alliance-users@asim.lip6.fr>
hcl = Hugo Clement <alliance-users@asim.lip6.fr>
javid = Farakh Javid <alliance-users@asim.lip6.fr>
karim = Karim Dioury <alliance-users@asim.lip6.fr>
labiadh = Forgotten Author (labiadh) <alliance-users@asim.lip6.fr>
ludo = Ludovic Jacomme <alliance-users@asim.lip6.fr>
masson = Christian Masson <alliance-users@asim.lip6.fr>
mitri = Forgotten Author (mitri) <alliance-users@asim.lip6.fr>
noury = Ludovic Noury <alliance-users@asim.lip6.fr>
pnt = Pierre Nguyen Tuong <alliance-users@asim.lip6.fr>
sirol = Olivier Sirol <alliance-users@asim.lip6.fr>
stephany = Stephanie Youssef <alliance-users@asim.lip6.fr>
xtof = Christophe Alexandre <alliance-users@asim.lip6.fr>
youssef = Stephanie Youssef <alliance-users@asim.lip6.fr>
jpc = Jean-Paul Chaput <Jean-Paul.Chaput@lip6.fr>
ramy = Ramy Iskander <Ramy.Iskander@lip6.fr>
roselyne = Roselyne Chotin   <Roselyne.Chotin-Avot@lip6.fr>
